16 13 21 21 21 21 21 21 14 16 16 16 16 16 16 16 16 16 16 16 16 16 16 16 16
16 17 25 25 25 25 25 25 15 16 16 16 16 16 16 16 16 16 16 16 16 16 16 16 16
16 17 25 25 25 25 25 25 15 16 16 16 16 16 16 16 16 16 16 16 16 16 16 16 16
16 17 25 25 10 12 25 25 15 16 16 16 16 16 16 16 16 16 16 16 16 16 16 16 16
16 17 25 25 20 22 25 25 15 16 16 16 16 13 21 21 21 14 16 16 16 16 13 21 14
16 17 25 25 25 25 25 25 15 16 16 16 16 17 25 25 25 20 14 16 16 13 22 25 15
16 17 25 25 25 25 25 25 20 21 14 16 16 17 25 25 25 25 15 13 21 22 25 25 15
16 18 11 11 11 12 25 25 25 25 20 21 21 22 25 25 25 25 20 22 25 25 25 25 20
16 16 16 16 16 18 12 25 25 25 25 25 25 25 25 25 25 25 25 25 25 25 25 25 25
16 16 16 16 16 16 18 11 11 11 11 11 12 25 25 25 25 10 12 25 25 25 25 25 10
16 16 16 16 16 16 16 16 16 16 16 16 18 12 25 25 10 19 17 25 25 10 12 25 15
16 16 16 16 16 16 16 16 16 16 16 13 21 22 25 10 19 16 17 25 25 20 22 25 15
16 16 16 16 16 16 16 16 16 13 21 22 25 25 25 15 13 21 22 25 25 25 25 25 15
16 16 16 16 16 16 16 16 16 17 25 25 25 25 10 19 17 25 25 25 25 25 10 11 19
16 16 16 16 16 16 16 16 16 17 25 25 25 25 15 16 17 25 25 25 25 25 15 16 16
16 16 16 16 16 16 16 16 16 17 25 25 25 25 15 16 18 11 11 11 11 11 19 16 16
16 16 16 16 16 16 16 16 16 18 11 11 11 11 19 16 16 16 16 16 16 16 16 16 16
16 16 16 16 16 16 16 16 16 16 16 16 16 16 16 16 16 16 16 16 16 16 16 16 16
16 16 16 16 16 16 16 16 16 16 16 16 16 16 16 16 16 16 16 16 16 16 16 16 16
16 16 16 16 16 16 16 16 16 16 16 16 16 16 16 16 16 16 16 16 16 16 16 16 16