4 4 7 7 7 7 7 7 4 4 4 4 4 4 4 4 4 4 4 4 4 4 4 4 4
4 5 9 9 9 9 9 9 3 4 4 4 4 4 4 4 4 4 4 4 4 4 4 4 4
4 5 9 9 9 9 9 9 3 4 4 4 4 4 4 4 4 4 4 4 4 4 4 4 4
4 5 9 9 0 2 9 9 3 4 4 4 4 4 4 4 4 4 4 4 4 4 4 4 4
4 5 9 9 6 8 9 9 3 4 4 4 4 4 7 7 7 4 4 4 4 4 4 7 4
4 5 9 9 9 9 9 9 3 4 4 4 4 5 9 9 9 6 4 4 4 4 8 9 3
4 5 9 9 9 9 9 9 6 7 4 4 4 5 9 9 9 9 3 4 7 8 9 9 3
4 4 1 1 1 2 9 9 9 9 6 7 7 8 9 9 9 9 6 8 9 9 9 9 6
4 4 4 4 4 4 2 9 9 9 9 9 9 9 9 9 9 9 9 9 9 9 9 9 9
4 4 4 4 4 4 4 1 1 1 1 1 2 9 9 9 9 0 2 9 9 9 9 9 0
4 4 4 4 4 4 4 4 4 4 4 4 4 2 9 9 0 4 5 9 9 0 2 9 3
4 4 4 4 4 4 4 4 4 4 4 4 7 8 9 0 4 4 5 9 9 6 8 9 3
4 4 4 4 4 4 4 4 4 4 7 8 9 9 9 3 4 4 8 9 9 9 9 9 3
4 4 4 4 4 4 4 4 4 5 9 9 9 9 0 4 4 5 9 9 9 9 0 1 4
4 4 4 4 4 4 4 4 4 5 9 9 9 9 3 4 4 5 9 9 9 9 3 4 4
4 4 4 4 4 4 4 4 4 5 9 9 9 9 3 4 4 4 1 1 1 1 4 4 4
4 4 4 4 4 4 4 4 4 4 1 1 1 1 4 4 4 4 4 4 4 4 4 4 4
4 4 4 4 4 4 4 4 4 4 4 4 4 4 4 4 4 4 4 4 4 4 4 4 4
4 4 4 4 4 4 4 4 4 4 4 4 4 4 4 4 4 4 4 4 4 4 4 4 4
4 4 4 4 4 4 4 4 4 4 4 4 4 4 4 4 4 4 4 4 4 4 4 4 4